1111111111111
1C010000000C1
100Z011111001
1P00110010001
100011E000C01
1111111111111