1111111111111111111111111
1000010000000000E00000001
10000000C0000000000000001
100100000000C000000000001
1001000000000000000P00001
1111111111111111111111111