11111111111111111111111111111111
10CCCC00000000000111111000000111
1110110100011111111111111110C111
10011111110111111000000000001111
10000000000000000000000000000111
10000000000000011111101111111111
10000001111111111000000000000111
11111100000000000111000011111111
11111100000000000111000011111111
11111100000000000111000011111111
111111000000000001110P0011111111
11111100000CCCC00111000011111111
111111000000000001111E1111111111
11111100000000000111111111111111
11111100000000000111111111111111
111111000000000CC111111111111111
11000000000000000111111111111111
11111111111111111111111111111111
11111111111111111111111111111111
11111111111111111111111111111111
